|----------|---|-----|-----------|
|..........+...|.+...|.........+.|
|].........|...|.|...|.........|.|
|..........|...+.|...|.........|.|
|..........|...|.|...|.........|.|
|..........|...|.|...|.........|.|
|..........|-|+|.|...|.........|.|
|--+-------| |.|.+...|.........|.|
|..........|-|.|--...|.........|.|
|..........+...|.+...+.........|.|
|..........|---|+---+|.........|.|
|..........|.........|.........|.|
|..........|.........|--+------|.|
|..........|.............|.....+.|
|..........|.............|.....|.|
|..........|.............|.....|.|
|..........|.............|.....|.|
|..........|.............|.....|.|
|..........|.............|.....|.|
|..........|.............|.....+.|
|+|------|+|+------|-|...|--+--|.|
|.+......|.........|.|...|.....|.|
|.|......|.........|.|...|.....|.|
|.|......|.........|.+...+.....|.|
|+|----+-|.........|+|---|----+|.|
|........|.........|...........|.|
|........|------+|+|...........|.|
|........|.......|.|...........|.|
|........|.......|-|--------+|-|-|
|........|.......|...|.......|...|
|........|.......|...|.......|...|
|........|.......+...+.......|...|
|+|+-----|+-+-+-------------+|--+|
|.|..............................|
|--------------------------------|